Molly	Newman
Fred	Pope
Diana	Romero
Shelia	Nguyen
Ted	Garner
Anne	Wolfe
Tasha	Lyons
Megan	Alvarado
Vernon	Roberson
Richard	Moody
Nancy	Ortega
Tara	Barton
Bernard	Gibbs
Roger	Daniels
Michael	Santos
Charlotte	Cruz
Ernesto	Knight
Joann	Washington
Sonya	Bishop
Ronald	Chambers
Lucia	Simpson
Harry	Ray
Ivan	Dean
Freddie	Copeland
Janie	Todd
Leonard	May
Merle	Maldonado
Duane	Cobb
Robyn	Rodriguez
Penny	Tran
Hugh	Reyes
Mae	Moore
Louis	Conner
Garrett	Holt
Aaron	Zimmerman
Shelly	Willis
Danielle	Brown
Felix	Cooper
Clarence	Ross
Patty	Tate
Phil	Rice
Wade	Bennett
Misty	Logan
Alton	Pena
Shawn	Johnston
Roderick	Gilbert
Bridget	Schwartz
Minnie	Shelton
Emily	Greer
Jody	Ortiz
Edwin	Fields
Jan	Schmidt
Guadalupe	Reed
Erma	Gregory
Lisa	Hansen
Corey	Flores
Kayla	Elliott
Ollie	Moss
Pauline	Kim
Sherman	Webb
Flora	Roy
Alan	Watson
Lois	Mullins
Santos	Brock
Pearl	Mathis
Darryl	Cole
Ruby	Stokes
Ken	Sanchez
Gloria	Reese
Sean	Edwards
Jean	Wilkerson
Trevor	Grant
Ashley	Nash
Eduardo	Hernandez
Natalie	Meyer
Arlene	Caldwell
Erik	Reeves
Florence	Horton
Daisy	Owens
Bernice	Black
Sheldon	Norman
Samantha	Young
Lora	Gordon
Shane	Andrews
Darlene	Fleming
Dewey	Myers
Roland	Douglas
Julius	Hanson
Dorothy	Bridges
Carole	Davis
George	Campbell
Jamie	Duncan
Al	Lamb
Rhonda	Jacobs
Gerald	Williams
Carrie	Brooks
Hubert	Keller
Marcus	Chapman
Cody	Goodman
Johnnie	Ruiz
